0,0,0,0,0,0,0,0,0,0,0,0,0,0,0,
0,5,5,1,1,1,1,0,1,1,1,1,1,1,0,
0,5,0,1,1,0,1,1,1,0,1,1,0,1,0,
0,1,1,5,0,0,5,5,5,0,0,5,1,1,0,
0,1,1,5,1,1,0,3,0,1,1,5,1,1,0,
0,1,0,5,1,2,0,5,0,2,1,5,0,1,0,
0,1,1,5,0,0,6,6,6,0,0,5,1,1,0,
0,0,1,5,5,3,6,4,6,3,5,5,1,0,0,
0,1,1,5,0,0,6,6,6,0,0,5,1,1,0,
0,1,0,5,1,2,0,5,0,2,1,5,0,1,0,
0,1,1,5,1,1,0,3,0,1,1,5,1,1,0,
0,1,1,5,0,0,5,5,5,0,0,5,1,1,0,
0,1,0,1,1,0,1,1,1,0,1,1,0,5,0,
0,1,1,1,1,1,1,0,1,1,1,1,5,5,0,
0,0,0,0,0,0,0,0,0,0,0,0,0,0,0,
0,0,0,0,0,0,0,0,0,0,0,0,0,0,0,
0,5,5,1,1,1,1,1,1,1,1,0,1,1,0,
0,5,0,0,1,1,0,5,1,5,1,0,2,1,0,
0,1,0,0,1,1,2,5,1,5,1,0,1,1,0,
0,1,1,1,0,1,0,5,1,5,3,1,1,1,0,
0,1,1,1,1,0,1,0,5,1,5,5,5,1,0,
0,1,0,2,0,1,6,6,6,5,1,1,1,1,0,
0,1,5,5,5,0,6,4,6,0,5,5,5,1,0,
0,1,1,1,1,5,6,6,6,1,0,2,0,1,0,
0,1,5,5,5,1,5,0,1,0,1,1,1,1,0,
0,1,1,1,3,5,1,5,0,1,0,1,1,1,0,
0,1,1,0,1,5,1,5,2,1,1,0,0,1,0,
0,1,2,0,1,5,1,5,0,1,1,0,0,5,0,
0,1,1,0,1,1,1,1,1,1,1,1,5,5,0,
0,0,0,0,0,0,0,0,0,0,0,0,0,0,0,
0,0,0,0,0,0,0,0,0,0,0,0,0,0,0,
0,5,5,1,1,1,1,1,1,1,1,1,1,2,0,
0,5,0,0,1,1,1,5,1,5,1,5,1,5,0,
0,5,0,2,1,0,1,1,1,1,1,1,5,5,0,
0,5,1,1,0,0,0,5,5,5,5,1,1,5,0,
0,5,1,0,0,3,1,1,1,3,5,1,5,5,0,
0,5,1,1,0,1,6,6,6,1,5,1,1,5,0,
0,5,5,1,5,1,6,4,6,1,5,1,5,5,0,
0,5,1,1,5,1,6,6,6,1,0,1,1,5,0,
0,5,5,1,5,3,1,1,1,3,0,0,1,5,0,
0,5,1,1,5,5,5,5,0,0,0,1,1,5,0,
0,5,5,1,1,1,1,1,1,0,1,2,0,5,0,
0,5,1,5,1,5,1,5,1,1,1,0,0,5,0,
0,2,1,1,1,1,1,1,1,1,1,1,5,5,0,
0,0,0,0,0,0,0,0,0,0,0,0,0,0,0,
0,0,0,0,0,0,0,0,0,0,0,0,0,0,0,
0,5,5,1,1,0,1,5,1,0,1,1,6,4,0,
0,5,1,1,1,1,1,5,1,1,1,1,6,6,0,
0,1,1,5,5,5,5,5,5,5,2,0,1,1,0,
0,1,1,5,1,1,1,1,1,1,0,2,1,1,0,
0,0,1,5,1,0,1,1,1,0,1,5,1,0,0,
0,1,1,5,1,1,5,3,0,1,1,5,1,1,0,
0,5,5,5,1,1,3,0,3,1,1,5,5,5,0,
0,1,1,5,1,1,0,3,5,1,1,5,1,1,0,
0,0,1,5,1,0,1,1,1,0,1,5,1,0,0,
0,1,1,2,0,1,1,1,1,1,1,5,1,1,0,
0,1,1,0,2,5,5,5,5,5,5,5,1,1,0,
0,6,6,1,1,1,1,5,1,1,1,1,1,5,0,
0,4,6,1,1,0,1,5,1,0,1,1,5,5,0,
0,0,0,0,0,0,0,0,0,0,0,0,0,0,0,
0,0,0,0,0,0,0,0,0,0,0,0,0,0,0,
0,5,5,1,1,1,1,1,1,1,1,1,1,1,0,
0,5,3,0,5,5,5,5,5,5,5,0,2,1,0,
0,1,0,0,0,1,1,1,1,1,0,0,0,1,0,
0,1,5,0,1,1,1,2,1,1,1,0,5,1,0,
0,1,5,0,1,5,5,5,5,5,1,0,5,1,0,
0,1,5,1,1,5,6,6,6,5,1,1,5,1,0,
0,1,5,1,1,5,6,4,6,5,1,1,5,1,0,
0,1,5,1,1,5,6,6,6,5,1,1,5,1,0,
0,1,5,0,1,5,5,5,5,5,1,0,5,1,0,
0,1,5,0,1,1,1,2,1,1,1,0,5,1,0,
0,1,0,0,0,1,1,1,1,1,0,0,0,1,0,
0,1,2,0,5,5,5,5,5,5,5,0,3,5,0,
0,1,1,1,1,1,1,1,1,1,1,1,5,5,0,
0,0,0,0,0,0,0,0,0,0,0,0,0,0,0,
0,0,0,0,0,0,0,0,0,0,0,0,0,0,0,
0,5,5,1,1,1,1,3,1,1,1,1,1,1,0,
0,5,0,1,1,0,1,0,1,0,1,3,0,1,0,
0,5,1,1,1,5,1,1,1,5,1,1,2,5,0,
0,5,1,1,1,5,1,2,1,5,1,1,1,5,0,
0,1,0,5,5,0,1,0,1,0,5,5,0,1,0,
0,5,1,1,1,1,6,6,6,1,1,1,1,5,0,
0,1,0,5,5,0,6,4,6,0,5,5,0,1,0,
0,5,1,1,1,1,6,6,6,1,1,1,1,5,0,
0,1,0,5,5,0,1,0,1,0,5,5,0,1,0,
0,5,1,1,1,5,1,2,1,5,1,1,1,5,0,
0,5,3,1,1,5,1,1,1,5,1,1,1,5,0,
0,1,0,2,1,0,1,0,1,0,1,1,0,5,0,
0,1,1,1,1,1,1,3,1,1,1,1,5,5,0,
0,0,0,0,0,0,0,0,0,0,0,0,0,0,0,
0,0,0,0,0,0,0,0,0,0,0,0,0,0,0,
0,5,5,1,1,1,5,3,5,1,1,1,6,4,0,
0,5,0,1,1,1,1,1,1,1,1,1,6,6,0,
0,1,1,0,1,1,1,5,1,1,1,0,1,1,0,
0,1,1,1,0,1,1,1,1,1,0,1,1,1,0,
0,1,1,1,1,0,5,5,5,0,1,1,1,1,0,
0,5,1,1,1,5,0,2,0,5,1,1,1,5,0,
0,3,1,5,1,5,2,0,2,5,1,5,1,3,0,
0,5,1,1,1,5,0,2,0,5,1,1,1,5,0,
0,1,1,1,1,0,5,5,5,0,1,1,1,1,0,
0,1,1,1,0,1,1,1,1,1,0,1,1,1,0,
0,1,1,0,1,1,1,5,1,1,1,0,1,1,0,
0,6,6,1,1,1,1,1,1,1,1,1,0,5,0,
0,5,6,1,1,1,5,3,5,1,1,1,5,5,0,
0,0,0,0,0,0,0,0,0,0,0,0,0,0,0,
0,0,0,0,0,0,0,0,0,0,0,0,0,0,0,
0,5,5,5,5,5,5,5,5,5,5,5,6,4,0,
0,5,0,0,0,0,0,0,0,0,0,0,0,6,0,
0,5,0,2,1,1,2,0,0,0,3,0,0,5,0,
0,5,0,0,1,0,0,0,1,1,1,1,0,5,0,
0,5,0,0,1,1,0,0,1,0,0,1,0,5,0,
0,5,0,0,0,1,0,2,1,3,0,1,0,5,0,
0,5,1,1,0,1,0,0,1,0,0,1,0,5,0,
0,5,0,1,0,1,0,0,1,1,0,1,0,5,0,
0,5,0,1,0,1,1,0,0,1,0,2,0,5,0,
0,5,0,1,1,1,0,0,0,1,0,0,0,5,0,
0,5,0,3,0,0,0,1,1,1,1,0,0,5,0,
0,6,0,0,0,0,0,1,0,0,0,0,0,5,0,
0,4,6,5,5,5,5,5,5,5,5,5,5,5,0,
0,0,0,0,0,0,0,0,0,0,0,0,0,0,0,
0,0,0,0,0,0,0,0,0,0,0,0,0,0,0,
0,5,5,1,1,1,0,3,0,1,1,1,1,5,0,
0,5,5,1,1,1,1,5,1,1,1,1,5,1,0,
0,1,1,5,1,1,1,5,1,1,1,5,1,1,0,
0,1,1,1,2,1,1,5,1,1,2,1,1,1,0,
0,1,1,1,1,5,5,5,5,5,1,1,1,1,0,
0,0,1,1,1,5,6,6,6,5,1,1,1,0,0,
0,3,5,5,5,5,6,4,6,5,5,5,5,3,0,
0,0,1,1,1,5,6,6,6,5,1,1,1,0,0,
0,1,1,1,1,5,5,5,5,5,1,1,1,1,0,
0,1,1,1,2,1,1,5,1,1,2,1,1,1,0,
0,1,1,5,1,1,1,5,1,1,1,5,1,1,0,
0,1,5,1,1,1,1,5,1,1,1,1,5,5,0,
0,5,1,1,1,1,0,3,0,1,1,1,5,5,0,
0,0,0,0,0,0,0,0,0,0,0,0,0,0,0,
0,0,0,0,0,0,0,0,0,0,0,0,0,0,0,
0,5,5,1,1,1,1,3,1,1,1,1,1,1,0,
0,5,0,0,0,0,5,0,5,0,0,0,0,1,0,
0,1,0,2,1,1,5,0,5,1,1,2,0,1,0,
0,1,0,1,1,1,5,0,5,1,1,1,0,1,0,
0,1,0,1,1,1,5,0,5,1,1,1,0,1,0,
0,1,5,5,5,5,6,6,6,5,5,5,5,1,0,
0,3,0,0,0,0,6,4,6,0,0,0,0,3,0,
0,1,5,5,5,5,6,6,6,5,5,5,5,1,0,
0,1,0,1,1,1,5,0,5,1,1,1,0,1,0,
0,1,0,1,1,1,5,0,5,1,1,1,0,1,0,
0,1,0,2,1,1,5,0,5,1,1,2,0,1,0,
0,1,0,0,0,0,5,0,5,0,0,0,0,5,0,
0,1,1,1,1,1,1,3,1,1,1,1,5,5,0,
0,0,0,0,0,0,0,0,0,0,0,0,0,0,0,
